111111111111111111
1P0000110010010101
100000E00001010001
100100010001000001
100011001000010001
100000000000000001
100010110010010101
111111111111111111