111111111111111111
1P0C00110010010101
100000000001010001
1CC1C001C001000001
100011C01C00010001
100000000000000001
100C10110010010101
111111111111111111