111111111111111111
100C00110010010101
100000E00001010001
1CC1C001C001000001
100011C01C00010001
100000000000000001
100C10110010010101
111111111111111111