1111111111111111
1P1CE01100100101
1100000000010101
1CC1C001C0010001
100011C01C000101
1000000000000001
100C1011001T0101
1111111111111111